######
#    #
#o   #
#A   #
######
