#####
## ##
# A #
## ##
#####