############
#o o o o   #
#@ @ @ @   #
#          #
#    A     #
############
