############
#o o o o   #
#@ @ @ @   #
#          #
#          #
############
