############
#      #
#@ @ @ @   #
#          #
#A         #
############
