############
#      #
#@ @ @ @   #
#    A     #
#          #
############
